name=Poziom 10
timeLimit=360
map=
      #######
     ##.....##
     #..BXB..#
     #.#b.b#.#
 #####..BXB..#####
##...##.....##...##
#..#..###X###..#..#
#.BbB.#.bBb.#.BbB.#
#.X.X.XXbpbXX.X.X.#
#.BbB.#.bBb.#.BbB.#
#..#..###X###..#..#
##...##.....##...##
 #####..BXB..#####
     #.#b.b#.#
     #..BXB..#
     ##.....##
      #######