name=Poziom 2
timeLimit=45
map=
 #######
 #.....#
 #.XbX.#
##.bpb.#
#..XbX.#
#......#
########