name=Poziom 3
timeLimit=60
map=
 ####
 #..####
 #.....##
##.##...#
#X.X#.pb##
#...#.bb.#
#..X#....#
##########