name=Poziom 4
timeLimit=45
map=
  ####   
###..####
#.......#
#pbBBBX.#
#.......#
#########