name=Poziom 5
timeLimit=120
map=
    #####
    #...#
    #b..#
  ###..b##
  #..b.b.#
###.#.##.#   ######
#...#.##.#####..XX#
#.b..b..........XX#
#####.###.#p##..XX#
    #.....#########
    #######