name=Poziom 6
timeLimit=210
map=
           ########
           #..XXXX#
############..XXXX#
#....#..b.b...XXXX#
#.bbb#b..b.#..XXXX#
#..b.....b.#..XXXX#
#.bb.#b.b.b########
#..b.#.....#
##.#########
#....#....#
#.....b...##
#..bb#bb..p#
#....#....##
###########