name=Poziom 7
timeLimit=90
map=
 ######### 
##.......##
#.X#####..#
#.X.....#.#
#.B.bb..#.#
#.B##.##..#
#.B...#..##
#.B##.#.##
#.P...#.#
#.b###..#
##.....##
 #######