name=Poziom 8
timeLimit=120
map=
 #######
 #..B..#
 #..p..#
 ##b#X##
 #..#..#
 #.b#X.#
 #..#..#
##.##.##
#..B.B.#
#...B..#
###...##
  #####