name=Poziom 9
timeLimit=180
map=
      ###
     ##.##
    ##...##
   ##.XbX.##
  ##..bXb..##
 ##.XbXbXbX.##
##..bXbPbXb..##
 ##.XbXbXbX.##
  ##..bXbb.###
   ##.XbX....#
    ##...#.#.#
     ##.##...#
      ########